50,250,450,450,250,50,250,350,250,150

50,50,50,450,450,450,150,250,350,250

0,1,0,0,0,1,0,0,0,0
1,0,1,0,0,0,1,0,0,0
0,1,0,1,0,0,0,0,0,0
0,0,1,0,1,0,0,0,0,0
0,0,0,1,0,1,0,0,1,0
1,0,0,0,1,0,0,0,0,0
0,1,0,0,0,0,0,1,1,1
0,0,0,0,0,0,1,0,1,0
0,0,0,0,1,0,1,1,0,1
0,0,0,0,0,0,1,0,1,0
